＊初期化
＄喋り間隔	１８０秒
＄喋り間隔誤差	１０％
＄会話時サーフェス戻し	有効
＄デフォルトサーフェス0	0
＄デフォルトサーフェス1	30
＄スコープ切り換え時	\n[half]
＄ユーザ名	ユーザ
＄自動挿入ウェイトの倍率	１００％
＄なでられ持続秒数	２
＄なでられ反応回数	６０
＄トーク中のなでられ反応	無効
＄自動アンカー	有効
＄ユーザ名	ユーザ
＄ユーザ敬称	さん	
＄５４名前	わたし
＄トーク乱数	０
＄名前付け済み	０
＄キスしだ	０
＄初回起動完了	０
＄５４性別	おんなのこ
＄プロポーズ	０
＄わがままトーク	０
＄消滅ボタン	1
＄消滅ボタンの状態	表示
＄叩き消滅	０
＄頭叩いだ回数	０
＄頭叩き消滅の状態	なし
＄靴あり	１
＄５４って名前好き	０
＄コミュキー設定	０
＄ユーザ性別	男性
＄誕生月	０
＄誕生日	０
＄前回年イベント	０
＄交際	０
＄好き	０
＄好感度	０
＄アバ茶を知る	０
＄処女	１
＄誕生日教えた	０
＠SAORI
